18 18 18 18 18 18 18 18 18 18 18 18 18 18 18 18 18 18 18 18 18 18 18 18 18 18 18 18 18 18
18 18 18 18 18 18 18 18 18 18 18 18 18 18 18 18 18 18 18 18 18 18 18 18 18 18 18 18 18 18
18 18 20 20 20 20 13 20 20 20 13 18 18 18 18 18 18 18 18 18 18 13 18 18 18 18 18 18 18 18
18 18 20 20 20 20 11 20 17 20 11 18 18 18 18 18 18 18 18 18 18 11 18 18 18 18 18 18 18 18
18 18 20 20 20 14 10 12 12 12 10 12 12 12 12 12 10 20 20 20 20 11 18 18 18 18 18 18 18 18
18 18 17 17 17 17 11 20 17 20 11 17 20 17 17 17 11 20 17 20 17 11 18 18 18 18 18 18 18 18
18 18 17 17 17 17 11 20 17 20 11 17 17 17 17 20 11 20 17 17 20 11 18 18 18 18 18 18 18 18
18 18 17 17 17 17 11 17 20 20 11 20 17 20 17 17 11 17 20 17 20 11 18 18 18 18 18 18 18 18
18 18 14 12 12 12 10 12 16 17 11 17 17 17 17 17 11 20 17 17 20 11 18 18 18 18 18 18 18 18
18 18 17 17 20 17 11 20 17 20 11 17 20 17 20 14 10 12 12 12 12 10 12 12 12 12 12 16 18 18
18 18 17 17 17 17 11 17 20 17 11 17 17 17 17 17 11 18 18 18 18 11 20 17 20 20 20 20 18 18
18 18 14 12 12 12 10 12 12 12 10 12 12 12 12 12 10 12 12 12 12 10 20 20 20 17 17 20 18 18
18 18 17 17 17 17 11 20 17 17 11 20 17 17 20 17 11 17 17 17 20 10 12 12 10 20 20 18 18 18
18 18 20 17 17 20 11 17 20 17 11 18 20 17 17 17 11 17 20 17 17 11 20 20 11 20 20 20 18 18
18 18 17 17 17 17 11 17 17 17 11 18 18 18 20 17 11 17 17 20 17 11 20 14 10 12 12 16 18 18
18 18 17 20 17 17 11 20 17 17 11 18 18 18 18 14 10 12 12 12 12 10 20 20 15 20 17 20 18 18
18 18 17 20 17 20 11 17 17 20 11 18 18 18 18 18 11 17 20 17 17 11 17 17 20 17 20 20 18 18
18 18 17 17 17 14 10 12 12 12 10 12 12 12 10 12 10 12 12 12 12 10 12 12 12 12 12 16 18 18
18 18 20 17 17 17 11 17 17 17 11 20 20 20 11 17 17 17 20 19 19 19 20 17 20 17 17 17 18 18
18 18 14 12 12 12 10 12 12 12 10 12 16 20 11 17 19 19 19 19 21 19 19 19 19 17 17 17 18 18
18 18 18 18 18 18 11 17 20 17 15 17 20 17 11 17 19 21 21 21 21 21 21 21 19 17 17 17 18 18
18 18 18 18 18 18 11 17 17 20 17 17 17 17 11 20 19 21 21 21 21 21 21 21 19 17 17 17 18 18
18 18 14 12 12 12 10 12 16 17 17 20 20 17 11 17 19 21 21 19 19 19 21 21 19 17 17 20 18 18
18 18 17 20 17 17 15 20 17 17 20 17 17 20 11 17 20 19 21 21 21 21 21 19 19 17 17 17 18 18
18 18 20 17 20 17 20 17 20 17 17 17 17 17 11 17 17 19 19 19 21 19 19 19 17 17 20 17 18 18
18 18 17 17 17 17 17 17 20 20 17 20 17 20 11 17 17 17 17 17 13 17 20 17 17 17 17 17 18 18
18 18 17 20 17 20 17 20 17 17 17 20 17 17 11 17 20 17 17 17 11 17 17 17 20 17 17 20 18 18
18 18 20 17 17 17 20 17 17 20 17 17 17 14 10 12 12 12 12 12 10 12 12 12 12 16 20 20 18 18
18 18 18 18 18 18 18 18 18 18 18 18 18 18 18 18 18 18 18 18 18 18 18 18 18 18 18 18 18 18
18 18 18 18 18 18 18 18 18 18 18 18 18 18 18 18 18 18 18 18 18 18 18 18 18 18 18 18 18 18





